COBM	Cobleskill St.
WELM	Wells
HUSM	Husson
JSC	Johnson State
UMWML	Mary Washington
RMCMLX14	Randolph-Macon
UMW	Mary Washington
HSC	Hampden-Sydney
BW-M	Baldwin Wallace
CAP-M	Capital
RWU	Roger Williams
LCMLAX14	Lasell
ELMHURST	Elmhurst
AUGIE	Augustana (IL)
CENTRE_M	Centre
RHODES	Rhodes
RIT	RIT
STE	Stevenson
DREWML14	Drew
USMMA	Merchant Marine
RIVIER	Rivier
SJMML14	Saint Joseph\'s
SRU	Salve Regina
WIT	Wentworth
YCP	York (Pa.)
MUHL	Muhlenberg
HOOD	Hood
MSOE	MSOE
AU	Aurora
ANMML	Anna Maria
MCL	Mitchell
DPUM	DePauw
DENM	#5 Denison
SCRMLX14	Scranton
GOUM	Goucher
MSMC-M	Mt. St. Mary (N.Y.)
MARITIME	Maritime (N.Y.)
UNE	U. of New England
CC	Curry
MIDMLAX	Middlebury
WESM14	Wesleyan (Conn.)
MIML	Misericordia
NUML	Neumann
WC	Washington College
FSU	Frostburg St.
TRANSY	Transylvania
HANOVER	Hanover
OWUM	Ohio Wesleyan
DENM	Denison
CST	Castleton
JSC	Johnson St.
THIEL	Thiel
OTT	Otterbein
NEC	New England Col.
IDA	Mount Ida
SWATM	Swarthmore
KINGSML	King\'s (Pa.)
HILM	Hilbert
MORM	Morrisville St.
LC	Lynchburg
COR	Cortland St.
UMF-M	Me.-Farmington
THOMAS	Thomas
OBEM	Oberlin
BENEDICT	Benedictine (IL)
MILLSAPS	Millsaps
JWUMLAX	Johnson &amp; Wales (RI)
MMA	Maine Maritime
COBM	SUNY Cobleskill
SWATMLAX	Swarthmore
EUML	Eastern
SITM	SUNYIT
BARD	Bard
PLATM1~1	Plattsburgh St.
WES	Wesley
SMC	St. Mary\'s (Md.)
RANDM	Randolph
BCM	Bridgewater (Va.)
PLATM14	Plattsburgh St.
GC	#16 Gettysburg
F&amp;M	Frank. &amp; Marsh.
HOPE	Hope
ALBION	Albion
KENMLX	Kenyon
BC	Beloit
MMA	Mass. Maritime
BAB	Babson
DC	Defiance
DENM	5 Denison
GC	16 Gettysburg
CLK	Clark University
MIT	MIT
RIT	Rochester Inst.
WILLIAMS	Williams
MSU	Montclair State
W&amp;J	Wash. &amp; Jefferson
WOO	Wooster
MMA	Massachusetts Maritime
IWU	Illinois Wesleyan
OLIVET	Olivet
CANTONM	SUNY Canton
SUSM	Susquehanna
BCML	Becker
SJMML14	Saint Joseph\'s (Me.)
SPR	Springfield
BACMLAX	Bryn Athyn
WITM	Wittenberg
